################
#              #
#              #
#              #
#              #
#              #
#              #
#       C      #
#              #
#              #
#              #
#              #
#              #
#              #
#              #
################