################
#       B      #
# ##############
#              #
#  ####   ######
#  #           #
#  # ##   ##   #
#  # #  C  #   #
#  # ######### #
#  #  #  #     #
#  #  #  # #####
#        #     #
## ####### #   #
#    #  #    # #
#  #      #    #
################